NO ./textures/north.png

SO ./textures/south.png

WE ./textures/west.png

EA ./textures/east.png

C 135, 206, 250

F 210, 180, 140

F 210, 180, 140

11111   111  11111111
10101   101  10100001
1010111110111101000011
1000000000100000000001
10100000001000000000011111
11111010000000111000000001
    10100W1000000000000001
11111000011000000000000101
10000000000000000011011111
1000010000000000000101
1000010000000101111111
1000010000000101
1000010000000101
1111000000000001111
   1000000000000001
   1111111111111111
