
NO ./textures/north.png

F 220, 100, 0

SO ./textures/south.png

C 225,  30, 0

WE ./textures/west.png
EA ./textures/east.png

1111111111111
1S11111111111
1000000000001
1111111111101
1000000000001
1011111111111
1000000000001
1111111111101
1000000000001
1011111111111
1000000000001
1111111111101
1000000000001
1011111111111
1000000000001
1111111111101
1000000000001
1011111111111
1000000000001
1111111111101
1000000000001
1011111111111
1000000000001
1111111111101
1000000000001
1011111111111
1000000000001
1111111111101
1000000000001
1011111111111
1000000000001
1111111111101
1000000000001
1011111111111
1000000000001
1111111111101
1000000000001
1011111111111
1000000000001
1111111111101
1000000000001
1011111111111
1000000000001
1111111111101
1000000000001
1011111111111
1000000000001
1111111111101
1000000000001
1011111111111
1000000000001
1111111111101
1000000000001
1011111111111
1000000000001
1111111111101
1000000000001
1011111111111
1000000000001
1111111111101
1000000000001
1011111111111
1000000000001
1111111111101
1000000000001
1011111111111
1000000000001
1111111111101
1000000000001
1011111111111
1000000000001
1111111111101
1000000000001
1011111111111
1000000000001
1111111111101
1000000000001
1011111111111
1000000000001
1111111111101
1000000000001
1011111111111
1000000000001
1111111111101
1000000000001
1011111111111
1000000000001
1111111111101
1111111111111
