1111111111111111
1000000000000001
1000111111111101
10001000000001E1
1000000000000111
1111111111CCCCC1
1000000000000001
1000000000000001
1000000000000001
1111111111111101
1000000000000001
1000000000000001
1000000000000001
1011111110000001
10000CCC100000P1
1111111111111111
