1111111111111111
1000000000000001
1000111111111101
10001000000001E1
1000000000000111
1011111111CCCCC1
1000010000000001
10X0000000000001
1000000001000001
1101111111111101
1000000000000001
1000000000000001
1000000000111001
1011111110000001
10000CCC100000P1
1111111111111111
