NO ./textures/north.png
SO ./textures/south.png
WE ./textures/west.png
EA ./textures/east.png

C 135, 206, 250
F 210, 180, 140

1111111111111111
1010000000100001
1010000000100001111111
1010000000100000000001
10100N0000000000000001
1000010000000000000101
1000010000000101111111
1000010000000101
1000010000000101
1111000000000001111
   1000000000000001
   1111111111111111
