NO ./textures/north.png
SO ./textures/south.png
WE ./textures/west.png
EA ./textures/east.png

F 220, 100, 0
C 225,  30, 0

        1111111111111111111111111
        1000000000110000000000001
        101100000111000P000P00001
        1001000000000000000000001
111111111011000001110000000000001
1000000000110000011101D111d111111
11110111111111011100000010001
11110111111111011101010010001
11000000110101011100000010001
10000P00000000001100000010001
10000000000000001101010010001
11000001110101011111011110N0111
11110111 1110101 101111010001
11111111 1111111 111111111111
