NO ./textures/north.png
SO ./textures/south.png
WE ./textures/west.png
EA ./textures/east.png

C 135, 206, 250
F 210, 180, 140

1111111111111111111111111
100011000000010000000111
10001100000001000000011
1000010000000100000001
10000100000010000000001
100011111000000010000011
1000000010001000000000001
1000N00010001000000011111
1000000010001111101111111
1000000000010000001
1000000000011011011
1000000000010000001
1000000000010000011
1111111111111111111
