EA ./textures/east.png
NO ./textures/north.png
WE ./textures/west.png
SO ./textures/south.png

C 135, 206, 250
F 210, 105, 30

111111111
100000001
10D000001
1D0100001
101000001
100000D01
100000P01
100EP0111
101100001
111111111
