NO ./textures/north.png
SO ./textures/south.png
WE ./textures/west.png
EA ./textures/east.png

C 135, 206, 250
F 210, 105, 30

1111111111111
1000000000001
1000111000001
10001 1000001
1000111000001
1000000000001       111
1111000000001111111 101
   1000S00000000001 101
   1000100000000001 101
1111000110001111111 101
1000000100001       101
1000000000001       101
10000011110011111111101
1000001  10000000000001
1111111  11111111111111
