NO ./textures/orb5.png
SO ./textures/orb6.png
WE ./textures/orb3.png
EA ./textures/orb8.png

C 135, 206, 250
F 210, 105, 30

11111111111
1E000000001
10000000001
10000000001
10000000001
10000000001
10000000001
10000000001
11111111111
