EA ./textures/east.png
NO ./textures/north.png
WE ./textures/west.png
SO ./textures/south.png

C 135, 206, 250
F 210, 105, 30

111111111
100000001
10P100001
100000001
1000N0001
100000001
100000P01
100000001
111111111
