NO ./textures/north.png
SO ./textures/south.png
WE ./textures/west.png
EA ./textures/east.png

F 220, 100, 0
C 225,  30, 0

1111111111111111
1010000000100001
1010000000100001
1010000000100001
10100N0000000001
1000010000000101
1000000000000001
1111111111111111
