NO ./textures/north.png
SO ./textures/south.png
WE ./textures/west.png
EA ./textures/east.png

F 220, 100, 0
C 225,  30, 0

11111111111111
101000N0001001
10100000001001
10100000001001
11111111111111
10100000000001
10000100000001
10000000000001
10000000000001
10000000000001
10000000000001
10000000000001
10000000000001
11111111111111
