NO ./textures/north.png
SO ./textures/south.png
WE ./textures/west.png
EA ./textures/east.png

C 135, 206, 250
F 210, 105, 30

1111111111
1000000001
1001000101
1001101101
1001010101
1001000101
1001000101
10010N0101
1000000001
1111111111
