NO ./textures/north.png
SO ./textures/south.png
WE ./textures/west.png

C 135, 206, 250
F 210, 105, 30

1111111111
1000000001
1001010101
1000101001

1001010101
1000000001
1000000001
10000N0001
1000000001
1111111111
