1111111111111
10010100000C1
1000011111001
1P00111000001
1111111111111
