1111111111111
10010E00000C1
1000011111001
1000111000001
1111111111111
