
NO ./textures/north.png

F 220, 100, 0

SO ./textures/south.png

C 225,  30, 0

WE ./textures/west.png
EA ./textures/east.png

1111111111111
1P00000000001
1000000000001
1d111111111D1
1000000000001
1d111111111D1
1000000000001
1d111111111D1
1000000000001
1d111111111D1
1000000000001
1d111111111D1
1000000000001
1d111111111D1
1000000000001
1d111111111D1
1000000000001
1d111111111D1
1000000000001
1d111111111D1
1000000000001
1d111111111D1
1000000000001
1d111111111D1
1000000000001
1d111111111D1
1000000000001
1d111111111D1
1000000000001
1d111111111D1
1000000000001
1d111111111D1
1000000000001
1d111111111D1
1000000000001
1d111111111D1
1000000000001
1d111111111D1
1000000000001
1d111111111D1
1000000000001
1E000000000P1
1111111111111
