


F 210, 105, 30
C 135, 206, 250



WE ./textures/west.png
EA ./textures/east.png
SO ./textures/south.png
NO ./textures/north.png



1111111111111
1000000000001
10001111000001
10001  1000001
10001  1000001
1000011000001
1000000000001       111
1111000000001111111 1P1
   1000S00000000001 101
   1000100000000001 101
1111000010001111111 101
1000000100001       101
1000000000001       101
1000001111DD111111111D11111111111111111111111111111111111111111111111111111111111111111111111
1000001  1000000000000000000000000000000000000000000000000000000000000000000000000000000000P1
1111111  111111111111111111111111111111111111111111111111111111111111111111111111111111111111
