NO ./textures/north.png
SO ./textures/south.png
WE ./textures/west.png
EA ./textures/east.png

C 135, 206, 250
F 210, 105, 30

11111111111111
100000S0000001
10100000001001
10100000001001
10111111111001
10100000000001
101111P0000001
10000000000001
10000000000001
10000000000001
10000000000001
10P00000000001
10000000000001
11111111111111
