NO ./textures/north.png
SO ./textures/south.png
WE ./textures/west.png
EA ./textures/east.png

F 220, 100, 42
C 225,  30, 42

        1111111111111111111111111
        1000000000110000000000001
        1011000001110000000000001
        100100000DDD0000000000001
111111111011000001110000000000001
100000000011000001110111111111111
1111d111111111011100000010001
1111d111111111011101010010001
1100000P110101011100000010001
10000000000000001100000010001
10000000000000001101010010001
11000001110101011111011110N0111
11110111 1110101 1011110P0001
11111111 1111111 111111111111
