
   EA   ./textures/east.png
	NO		./textures/north.png
 	 	 WE 	 	./textures/west.png
	 	 	 SO	 	 ./textures/south.png

   C    135,    206,    250
		F	210,		105,			30

111111111
1E00000001
11111111001
1000000001
100000001
10000001
1000001
100001
10001
1001
101
101
101
101
101
101
101
101
101
101
101
101
101
101
101
101
101         11
101        1001
101       1001
101      1001
101     1001
101    1001
101   1001
101  1001
101 1001
1011001
101001
10101
10001
11111
