EA ./textures/east.png
NO ./textures/north.png
WE ./textures/west.png
SO ./textures/south.png

C 135, 206, 250
F 210, 105, 30

111111111111111111111
100000000000000000001
100000000000000000001
100000000000000000001
100000001101111110001
100000011001100110001
100000110000000110001
100001100000001100001
100011000000011000001
100011111100011000001
100000001100110000001
100000001101100000001
100000001101100110001
100000001101111110001
100000001100000000001
100000001100000000001
100000000000000000001
1000000000N0000000001
100000000000000000001
100000000000000000001
111111111111111111111
